00000000000000000000000000001111
00000000000000000000000000001111
00000000000011000000000000001111
00000000000011000000000000001111
00000000000011110000000011111111
00011111100011000000000000001111
00000000000011000000000000001111
00000000000011000000000001001111
00000000000011000000000000001111
00011100000011000000000000000000
00000000000011000000000000000000
00000000000011000001111000000000
00000000000011000010000000000000
00000000000000000000000000000000
00000000000000000000100000000000
00000000011111111000000000000000
00000000000000111100000000000000
00000100000000000000000000000000
00000000000000000000000000001111
11111111111111111111111111111111
