1111111111111000011111100001111111111111
1000001000100000000110000000010001000001
0000000000100000000110000000010001000000
0000000000100000000110000000010000000000
1000000000000000000000000000000000000001
1000001000000000000000000000000001000001
1000001000000000000000000000000001000001
1000001000000000001001000000000001000001
1000000000000000011001100000000000000001
1000000000001001110000111001000000000001
1000000000000001000000001000000000000001
1000000000000001000000001000000000000001
0000000000000001000000001000000000000000
0000000001100000000000000000011000000000
0000000001000000000000000000001000000000
1111100001100000000110000000011000011111
1000000000000000001001000000000000000001
0010100000000000000000000000000000010100
1000000000000000000000000000000000000001
1111111111111000011111100001111111111111
