0001111110011111111001111111100111111000
0001111110001100000000000011000111111000
0001111110001100000000000011000111111000
1111111100000000000000000000000011111111
0000000000000000000110000000000000000000
0000000000000000000000000000000000000000
1111111111110000000000000000111111111111
1111111110000000000000000000000111111111
0011110000000000000000000000000000111100
0001100000000000001111000000000000011000
0001100000000001111111111000000000011000
0001100000000011111111111100000000011000
0001100000000000011111100000000000011000
1111111100000000000000000000000011111111
0111111000000000000000000000000001111110
0011110000000000000000000000000000111100
0011110000000000000000000000000000111100
0011110000011110000000000111100000111100
1111111110011110000000000111100111111111
1111111110011111111001111111100111111111
